00000000000000000000
00011111000011100000
00011101111011100000
00011101111011100000
00000011111010001110
00000001111111111110
00001111111111111110
00001111111010111110
10001111110010001110
00001111110010000000
00000010110010000000
00000010110010000000
00000010110010000000
00000010110010000000
00001111111111100000
00001111111111100000
00001111101111100000
00001111000000000000
00001111000000000000
00000000000000000000
